let map_level1 = [
  [1,1,1,1,1, 1,1,1,1,1, 1,1,1,1,1, 1,1,1,1,1, 1,1,1,1,1, 1,1,1,1,1],
  [1,0,0,0,0, 0,0,0,0,0, 0,0,0,0,0, 0,0,0,0,0, 0,0,0,0,0, 0,0,0,0,1],
  [1,0,1,1,1, 1,0,1,1,1, 1,0,1,1,1, 1,1,1,0,1, 1,1,1,0,1, 1,1,1,0,1],
  [1,0,1,1,1, 1,0,1,1,1, 1,0,1,1,1, 1,1,1,0,1, 1,1,1,0,1, 1,1,1,0,1],
  [1,0,1,1,1, 1,0,1,1,1, 1,0,1,1,1, 1,1,1,0,1, 1,1,1,0,1, 1,1,1,0,1], 
  [1,0,1,1,1, 1,0,1,1,1, 1,0,1,1,1, 1,1,1,0,1, 1,1,1,0,1, 1,1,1,0,1],
  [1,0,0,0,0, 0,0,0,0,0, 0,0,0,0,0, 0,0,0,0,0, 0,0,0,0,0, 0,0,0,0,1],
  [1,0,1,1,1, 1,0,1,1,1, 1,0,1,1,1, 1,1,1,0,1, 1,1,1,0,1, 1,1,1,0,1],
  [1,0,1,1,1, 1,0,1,1,1, 1,0,1,1,1, 1,1,1,0,1, 1,1,1,0,1, 1,1,1,0,1],
  [1,0,1,1,1, 1,0,1,1,1, 1,0,1,1,1, 1,1,1,0,1, 1,1,1,0,1, 1,1,1,0,1],
  [1,0,1,1,1, 1,0,1,1,1, 1,0,1,1,1, 1,1,1,0,1, 1,1,1,0,1, 1,1,1,0,1],
  [1,0,0,0,0, 0,0,0,0,0, 0,0,0,0,0, 0,0,0,0,0, 0,0,0,0,0, 0,0,0,0,1],
  [1,0,1,1,1, 1,0,1,1,1, 1,0,1,1,1, 1,1,1,0,1, 1,1,1,0,1, 1,1,1,0,1],
  [1,0,1,1,1, 1,0,1,1,1, 1,0,1,1,1, 1,1,1,0,1, 1,1,1,0,1, 1,1,1,0,1],
  [1,0,1,1,1, 1,0,1,1,1, 1,0,1,1,1, 1,1,1,0,1, 1,1,1,0,1, 1,1,1,0,1],
  [1,0,1,1,1, 1,0,1,1,1, 1,0,1,1,1, 1,1,1,0,1, 1,1,1,0,1, 1,1,1,0,1],
  [1,0,1,1,1, 1,0,1,1,1, 1,0,1,1,1, 1,1,1,0,1, 1,1,1,0,1, 1,1,1,0,1],
  [1,0,1,1,1, 1,0,1,1,1, 1,0,1,1,1, 1,1,1,0,1, 1,1,1,0,1, 1,1,1,0,1],
  [1,0,0,0,0, 0,0,0,0,0, 0,0,0,0,0, 0,0,0,0,0, 0,0,0,0,0, 0,0,0,0,1],
  [1,0,1,1,1, 1,0,1,1,1, 1,0,1,1,1, 1,1,1,0,1, 1,1,1,0,1, 1,1,1,0,1], 
  [1,0,1,1,1, 1,0,1,1,1, 1,0,1,1,1, 1,1,1,0,1, 1,1,1,0,1, 1,1,1,0,1],
  [1,0,1,1,1, 1,0,1,1,1, 1,0,1,1,1, 1,1,1,0,1, 1,1,1,0,1, 1,1,1,0,1],
  [1,0,1,1,1, 1,0,1,1,1, 1,0,1,1,1, 1,1,1,0,1, 1,1,1,0,1, 1,1,1,0,1],
  [1,0,0,0,0, 0,0,0,0,0, 0,0,0,0,0, 0,0,0,0,0, 0,0,0,0,0, 0,0,0,0,1],
  [1,0,1,1,1, 1,0,1,1,1, 1,0,1,1,1, 1,1,1,0,1, 1,1,1,0,1, 1,1,1,0,1],
  [1,0,1,1,1, 1,0,1,1,1, 1,0,1,1,1, 1,1,1,0,1, 1,1,1,0,1, 1,1,1,0,1],
  [1,0,1,1,1, 1,0,1,1,1, 1,0,1,1,1, 1,1,1,0,1, 1,1,1,0,1, 1,1,1,0,1],
  [1,0,1,1,1, 1,0,1,1,1, 1,0,1,1,1, 1,1,1,0,1, 1,1,1,0,1, 1,1,1,0,1],
  [1,0,0,0,0, 0,0,0,0,0, 0,0,0,0,0, 0,0,0,0,0, 0,0,0,0,0, 0,0,0,0,1],
  [1,1,1,1,1, 1,1,1,1,1,1, 1,1,1,1,1, 1,1,1,1,1, 1,1,1,1,1, 1,1,1,1],
];

let map_level2 = [
  [1,1,1,1,1, 1,1,1,1,1, 1,1,1,1,0, 0,1,1,1,1, 1,1,1,1,1, 1,1,1,1,1],
  [1,0,0,0,0, 0,0,0,0,0, 0,0,0,1,0, 0,1,0,0,0, 0,0,0,0,0, 0,0,0,0,1],
  [1,0,1,1,1, 1,0,0,1,1, 1,1,0,1,0, 0,1,0,1,1, 1,1,0,0,1, 1,1,1,0,1],
  [1,0,1,0,0, 0,0,0,0,0, 0,1,0,1,0, 0,1,0,1,0, 0,0,0,0,0, 0,0,1,0,1],
  [1,0,1,0,0, 0,1,1,0,0, 0,1,0,1,0, 0,1,0,1,0, 0,0,1,1,0, 0,0,1,0,1], 
  [1,0,1,0,0, 0,0,0,0,0, 0,1,0,1,0, 0,1,0,1,0, 0,0,0,0,0, 0,0,1,0,1],
  [1,0,0,0,1, 0,1,1,0,1, 0,0,0,1,0, 0,1,0,0,0, 1,0,1,1,0, 1,0,0,0,1],
  [1,0,0,0,1, 0,1,1,0,1, 0,0,0,1,1, 1,1,0,0,0, 1,0,1,1,0, 1,0,0,0,1],
  [1,0,1,0,0, 0,0,0,0,0, 0,1,0,0,0, 0,0,0,1,0, 0,0,0,0,0, 0,0,1,0,1],
  [1,0,1,0,0, 0,1,1,0,0, 0,1,0,0,1, 1,0,0,1,0, 0,0,1,1,0, 0,0,1,0,1], 
  [1,0,1,0,0, 0,0,0,0,0, 0,1,0,0,1, 1,0,0,1,0, 0,0,0,0,0, 0,0,1,0,1],
  [1,0,1,1,1, 1,0,0,1,1, 1,1,0,0,1, 1,0,0,1,1, 1,1,0,0,1, 1,1,1,0,1],
  [1,0,0,0,0, 0,0,0,0,0, 0,0,0,0,0, 0,0,0,0,0, 0,0,0,0,0, 0,0,0,0,1],
  [1,1,1,1,1, 1,1,1,0,0, 0,0,0,1,1, 1,1,0,0,0, 0,0,1,1,1, 1,1,1,1,1],
  [0,0,0,0,0, 0,0,1,0,1, 1,1,0,1,0, 0,1,0,1,1, 1,0,1,0,0, 0,0,0,0,0], 
  [0,0,0,0,0, 0,0,1,0,1, 1,1,0,1,0, 0,1,0,1,1, 1,0,1,0,0, 0,0,0,0,0],
  [1,1,1,1,1, 1,1,1,0,0, 0,0,0,1,1, 1,1,0,0,0, 0,0,1,1,1, 1,1,1,1,1],
  [1,0,0,0,0, 0,0,0,0,0, 0,0,0,0,0, 0,0,0,0,0, 0,0,0,0,0, 0,0,0,0,1],
  [1,0,1,1,1, 1,0,0,1,1, 1,1,0,0,1, 1,0,0,1,1, 1,1,0,0,1, 1,1,1,0,1],
  [1,0,1,0,0, 0,0,0,0,0, 0,1,0,0,1, 1,0,0,1,0, 0,0,0,0,0, 0,0,1,0,1],
  [1,0,1,0,0, 0,1,1,0,0, 0,1,0,0,1, 1,0,0,1,0, 0,0,1,1,0, 0,0,1,0,1],
  [1,0,1,0,0, 0,0,0,0,0, 0,1,0,0,0, 0,0,0,1,0, 0,0,0,0,0, 0,0,1,0,1],
  [1,0,0,0,1, 0,1,1,0,1, 0,0,0,1,1, 1,1,0,0,0, 1,0,1,1,0, 1,0,0,0,1],
  [1,0,0,0,1, 0,1,1,0,1, 0,0,0,1,0, 0,1,0,0,0, 1,0,1,1,0, 1,0,0,0,1],
  [1,0,1,0,0, 0,0,0,0,0, 0,1,0,1,0, 0,1,0,1,0, 0,0,0,0,0, 0,0,1,0,1],
  [1,0,1,0,0, 0,1,1,0,0, 0,1,0,1,0, 0,1,0,1,0, 0,0,1,1,0, 0,0,1,0,1],
  [1,0,1,0,0, 0,0,0,0,0, 0,1,0,1,0, 0,1,0,1,0, 0,0,0,0,0, 0,0,1,0,1],
  [1,0,1,1,1, 1,0,0,1,1, 1,1,0,1,0, 0,1,0,1,1, 1,1,0,0,1, 1,1,1,0,1],
  [1,0,0,0,0, 0,0,0,0,0, 0,0,0,1,0, 0,1,0,0,0, 0,0,0,0,0, 0,0,0,0,1],
  [1,1,1,1,1, 1,1,1,1,1,1, 1,1,1,0, 0,1,1,1,1, 1,1,1,1,1, 1,1,1,1,1],
];

let map_level3 = [
  [1,1,1,1,1, 1,1,1,1,1, 1,1,1,1,1, 1,1,1,1,1, 1,1,1,1,1, 1,1,1,1,1],
  [1,0,0,0,0, 0,0,1,1,1, 1,0,0,0,1, 1,0,0,0,1, 1,1,1,0,0, 0,0,0,0,1],
  [1,0,1,0,0, 1,0,0,1,1, 1,0,1,0,1, 1,0,1,0,1, 1,1,0,0,1, 0,0,1,0,1],
  [1,0,0,1,0, 0,1,0,0,1, 1,0,1,0,1, 1,0,1,0,1, 1,0,0,1,0, 0,1,0,0,1],
  [1,0,0,0,1, 0,0,1,0,1, 1,0,1,0,1, 1,0,1,0,1, 1,0,1,0,0, 1,0,0,0,1],
  [1,0,1,0,0, 1,0,0,0,1, 1,0,1,0,1, 1,0,1,0,1, 1,0,0,0,1, 0,0,1,0,1],
  [1,0,0,1,0, 0,1,0,0,1, 1,0,1,0,1, 1,0,1,0,1, 1,0,0,1,0, 0,1,0,0,1],
  [1,1,0,0,1, 0,0,1,0,0, 0,0,1,0,0, 0,0,1,0,0, 0,0,1,0,0, 1,0,0,1,1],
  [1,1,1,0,0, 0,0,0,0,0, 1,1,1,0,0, 0,0,1,1,1, 0,0,0,0,0, 0,0,1,1,1],
  [1,1,1,1,1, 1,1,0,0,0, 0,0,0,0,1, 1,0,0,0,0, 0,0,0,1,1, 1,1,1,1,1],
  [1,1,1,1,1, 1,1,0,1,0, 1,0,0,0,0, 0,0,0,0,1, 0,1,0,1,1, 1,1,1,1,1],
  [1,0,0,0,0, 0,0,0,1,0, 0,0,1,1,0, 0,1,1,0,0, 0,1,0,0,0, 0,0,0,0,1],
  [1,0,1,1,1, 1,1,1,1,0, 0,1,1,0,0, 0,0,1,1,0, 0,1,1,1,1, 1,1,1,0,1],
  [1,0,0,0,0, 0,0,0,0,0, 0,1,0,0,0, 0,0,0,1,0, 0,0,0,0,0, 0,0,0,0,1],
  [1,1,1,1,1, 1,1,0,0,1, 0,0,0,0,1, 1,0,0,0,0, 1,0,0,1,1, 1,1,1,1,1],
  [1,1,1,1,1, 1,1,0,0,1, 0,0,0,0,1, 1,0,0,0,0, 1,0,0,1,1, 1,1,1,1,1],
  [1,0,0,0,0, 0,0,0,0,0, 0,1,0,0,0, 0,0,0,1,0, 0,0,0,0,0, 0,0,0,0,1],
  [1,0,1,1,1, 1,1,1,1,0, 0,1,1,0,0, 0,0,1,1,0, 0,1,1,1,1, 1,1,1,0,1],
  [1,0,0,0,0, 0,0,0,1,0, 0,0,1,1,0, 0,1,1,0,0, 0,1,0,0,0, 0,0,0,0,1],
  [1,1,1,1,1, 1,1,0,1,0, 1,0,0,0,0, 0,0,0,0,1, 0,1,0,1,1, 1,1,1,1,1],
  [1,1,1,1,1, 1,1,0,0,0, 0,0,0,0,1, 1,0,0,0,0, 0,0,0,1,1, 1,1,1,1,1],
  [1,1,1,0,0, 0,0,0,0,0, 1,1,1,0,0, 0,0,1,1,1, 0,0,0,0,0, 0,0,1,1,1],
  [1,1,0,0,1, 0,0,1,0,0, 0,0,1,0,0, 0,0,1,0,0, 0,0,1,0,0, 1,0,0,1,1],
  [1,0,0,1,0, 0,1,0,0,1, 1,0,1,0,1, 1,0,1,0,1, 1,0,0,1,0, 0,1,0,0,1],
  [1,0,1,0,0, 1,0,0,0,1, 1,0,1,0,1, 1,0,1,0,1, 1,0,0,0,1, 0,0,1,0,1],
  [1,0,0,0,1, 0,0,1,0,1, 1,0,1,0,1, 1,0,1,0,1, 1,0,1,0,0, 1,0,0,0,1],
  [1,0,0,1,0, 0,1,0,0,1, 1,0,1,0,1, 1,0,1,0,1, 1,0,0,1,0, 0,1,0,0,1],
  [1,0,1,0,0, 1,0,0,1,1, 1,0,1,0,1, 1,0,1,0,1, 1,1,0,0,1, 0,0,1,0,1],
  [1,0,0,0,0, 0,0,1,1,1, 1,0,0,0,1, 1,0,0,0,1, 1,1,1,0,0, 0,0,0,0,1],
  [1,1,1,1,1, 1,1,1,1,1, 1,1,1,1,1, 1,1,1,1,1, 1,1,1,1,1, 1,1,1,1,1],
];
